WE ress/textures/redbrick.xpm

NO ress/textures/brick_2.xpm



SO ress/textures/redbrick.xpm


F 69,222,199


EA ress/textures/redbrick.xpm

C 235,198,52






1111111
1100011
1000001
100N001
1000001
1111111