WE textures/wolfenstein/eagle.xpm 

NO textures/wolfenstein/grey_stone.xpm



SO textures/wolfenstein/red_brick.xpm


F 69,222,199


EA textures/wolfenstein/mossy.xpm

C 235,198,52






        111111111111111111111111
11111111100000000000000000000001
10000000000000000000000111100011
100000000W00000000000001   111
100000000000000000000001
100000000000000000000001
100000000000000000000001
10001111100001010100011
100000100000000000000001
100000100010000100010001
100000100010000000000001
100000111100001010100001
100000000000000000000001
100000000000000000000001
100000000000000000000001
100000000000000000000001
100000000000000000000001
100000000000000000000001
100000000000000000000001
111111111000000000000001
100100001000000000000001
100000101000000000000001
100100001000000000000001
100111111000000000000001
100000000000000000000001
100000000000000000000001
111111111111111111111111
