WE ress/textures/redbrick.xpm

NO ress/textures/redbrick.xpm



SO ress/textures/redbrick.xpm


F 69,222,199


EA ress/textures/redbrick.xpm

C 235,198,52






1111111
1110001
1000001
1000001
1000001
1000001
1000001
10N0001
1000001
1111111