WE ress/textures/redbrick.xpm

NO ress/textures/redbrick.xpm



SO ress/textures/redbrick.xpm


F 69,222,199


EA ress/textures/redbrick.xpm

C 235,198,52






11111
10001
10N01
10001
11111