WE ress/textures/redbrick.xpm

NO ress/textures/redbrick.xpm



SO ress/textures/redbrick.xpm


F 69,222,199


EA ress/textures/redbrick.xpm

C 235,198,52






11111111111
10000000001
10000000001
10000000001
10000E00001
10000000001
11111111111